###########E#########
# #         #       #
# # # ##### # # ### #
#   # #   # # # #   #
##### # # # ### # ###
#     # # # #   #   #
# ####### # # ##### #
# #     # # #     # #
# # ### # # ##### # #
# #   # #         # #
# ### # # ###########
#     # # # #   #   #
####### # # # # # ###
#       #   # #   # #
# ######### # ##### #
#   #       # #     #
# # ######### ##### #
# # #   #   #   #   #
# # # # # # ### # # #
# #   #   #       # #
###########X#########