#########E#######
#               #
############### #
#               #
# ############# #
# #           # #
# ### # # ##### #
#   # # # #     #
### ### # # #####
#   #   # #     #
##### ### ##### #
#       #     # #
# ##### ##### # #
# # #   #     # #
# # # ######### #
#   #           #
#########X#######
