###########E#########
#         #   # #   #
##### ### # # # # # #
#   #   #   # #   # #
# # ### ##### ### # #
# #   #   # #   # # #
##### ### # ### ### #
# #   #   #   #     #
# # ### ### ####### #
#       #           #
###########X#########



